21,21,21,21,21,21,21,21,21,21,21,21,21,21,17,11,11,11,16,21
21,21,21,21,21,21,21,17,11,11,11,11,11,11,12,03,03,04,09,21
21,21,21,21,21,21,21,13,15,22,22,22,22,22,14,07,07,06,09,21
21,21,21,21,21,21,21,13,09,21,21,21,21,21,13,00,00,00,09,21
21,21,21,21,21,21,21,13,09,21,21,21,21,21,18,22,22,22,19,21
21,21,21,21,21,21,21,13,09,21,21,21,21,21,21,21,21,21,21,21
21,21,21,21,21,17,11,12,01,16,21,21,21,21,21,21,21,21,21,21
21,21,21,21,21,13,08,08,08,01,11,16,21,21,21,21,21,21,21,21
21,21,21,21,21,18,22,14,07,07,08,09,21,21,21,21,21,21,21,21
21,21,21,21,21,17,11,12,00,00,05,01,11,16,21,21,21,21,21,21
21,21,21,21,21,13,08,00,08,00,04,08,08,09,21,21,21,21,21,21
21,17,11,11,11,12,02,15,22,14,02,07,00,09,21,21,21,21,21,21
21,13,08,08,08,08,08,09,21,13,01,00,00,09,21,21,21,21,21,21
21,13,08,15,14,01,07,01,16,13,06,00,00,09,21,21,21,21,21,21
21,13,08,09,18,22,14,07,01,12,08,03,04,09,21,21,21,21,21,21
21,13,08,09,21,21,13,02,04,08,15,14,08,09,21,21,21,21,21,21
21,13,08,09,21,21,18,14,08,15,19,13,08,01,16,21,21,21,21,21
21,13,15,19,21,21,21,13,08,09,21,13,08,15,19,21,21,21,21,21
21,13,09,21,21,21,21,18,22,19,21,13,08,09,21,21,21,21,21,21
21,13,01,11,11,16,21,21,21,21,21,13,08,09,21,21,21,21,21,21
21,13,08,08,08,09,17,11,11,16,17,12,08,01,16,21,21,21,21,21
21,13,08,08,08,09,13,08,08,09,13,02,07,06,09,21,21,21,21,21
21,18,14,08,08,09,13,08,08,09,13,01,00,05,09,21,21,21,21,21
21,21,18,22,22,19,18,22,22,19,13,02,03,04,09,21,21,21,21,21
21,21,21,21,21,21,21,21,21,21,18,22,22,22,19,21,21,21,21,21