16-00,17-00,18-00,19-00,20-00,21-00,22-00,23-00,24-00,18-00,19-00,20-00,21-00,22-00,23-00,24-00,18-00,19-00,20-00,21-00,22-00,23-00,24-00,25-00,26-00
16-01,17-01,00-00,01-00,02-00,03-00,04-00,05-00,06-00,07-00,08-00,09-00,10-00,11-00,12-00,13-00,14-00,15-00,16-00,15-00,14-00,14-00,14-00,25-03,01-01
16-02,17-02,00-01,01-01,02-01,03-01,04-01,05-01,06-01,07-01,08-01,09-01,10-01,11-01,27-00,28-00,29-00,30-00,31-00,15-01,14-01,14-01,14-01,25-03,01-01
16-03,17-03,00-02,01-02,02-02,03-02,04-02,05-02,06-02,07-02,08-02,09-02,10-02,11-02,27-01,28-01,29-01,30-01,31-01,15-02,14-02,14-02,14-02,25-03,01-01
16-04,17-04,00-03,01-03,02-03,03-03,04-03,05-03,06-03,07-03,08-03,09-03,10-03,11-03,27-02,28-02,29-02,30-02,31-02,14-03,14-03,14-03,14-03,25-03,01-01
16-05,17-05,00-04,01-04,02-04,03-04,04-04,05-04,06-04,07-04,08-04,09-04,10-04,11-04,27-03,28-03,29-03,30-03,31-03,15-04,18-04,14-04,14-04,25-03,01-01
16-06,17-01,00-05,01-05,02-05,03-05,04-05,05-05,06-05,07-05,08-05,09-05,10-05,11-05,27-04,28-04,29-04,30-04,31-04,14-03,18-05,19-05,20-05,25-03,01-01
16-07,17-02,00-06,01-06,02-06,03-06,04-06,05-06,06-06,07-06,08-06,09-06,10-06,11-06,12-06,13-06,14-06,15-06,16-06,14-06,13-07,13-07,13-07,25-03,01-01
16-08,17-03,00-07,01-07,02-07,03-07,04-07,05-07,06-07,07-07,08-07,09-07,10-07,11-07,12-07,13-07,14-07,15-07,14-03,14-07,13-07,13-07,13-07,25-03,01-01
16-00,17-04,00-08,01-08,02-08,03-08,04-08,05-08,06-08,07-08,08-08,09-08,10-08,17-11,18-11,19-11,20-11,21-11,22-11,23-11,24-11,25-11,13-07,25-03,01-01
16-01,17-05,00-09,01-09,02-09,03-09,04-09,05-09,06-09,07-09,08-09,09-09,10-09,17-12,18-12,19-12,20-12,21-12,22-12,23-12,24-12,25-12,20-09,25-03,01-01
16-02,17-01,00-10,01-10,02-10,03-10,04-10,05-10,06-10,07-10,08-10,09-10,10-10,17-13,18-13,19-13,20-13,21-13,22-13,23-13,24-13,25-13,20-10,25-03,01-01
16-03,17-02,00-11,01-11,02-11,03-11,04-11,05-11,06-11,07-11,08-11,09-11,10-11,17-14,18-14,19-14,20-14,21-14,22-14,23-14,24-14,25-14,20-10,25-03,01-01
16-04,17-03,00-12,01-12,02-12,03-12,04-12,05-12,06-12,07-12,08-12,09-12,10-12,17-15,18-14,19-14,20-15,21-15,22-15,23-15,24-15,25-15,20-10,25-03,01-01
16-02,17-04,00-13,01-13,02-13,03-13,04-13,05-13,06-13,07-13,08-13,09-13,10-13,17-16,18-16,19-16,20-16,21-16,22-16,23-16,24-16,25-16,20-10,25-04,01-01
16-03,17-03,00-14,00-00,00-00,00-00,04-14,05-14,06-14,07-14,08-14,09-14,10-14,17-17,18-17,19-17,20-17,21-17,22-17,23-17,24-17,25-17,20-10,25-05,01-01
16-04,17-06,18-06,19-06,20-06,21-06,18-06,19-06,20-06,21-06,21-06,18-06,19-06,20-06,21-06,21-06,18-06,19-06,20-06,21-06,21-06,18-06,19-06,25-06,01-01
16-08,17-07,18-07,19-07,20-07,21-07,18-07,19-07,20-07,21-07,21-07,18-07,19-07,20-07,21-07,21-07,18-07,19-07,20-07,21-07,21-07,18-07,19-07,25-07,01-01
16-00,17-08,18-08,19-08,20-08,21-08,18-08,19-08,20-08,21-08,21-08,18-08,19-08,20-08,21-08,21-08,18-08,19-08,20-08,21-08,21-08,18-08,19-08,25-08,01-01

1,1,1,1,1,1,1,1,1,1,1,1,1,1,1,1,1,1,1,1,1,1,1,1,1
1,1,1,1,1,1,1,1,1,1,1,1,1,1,1,1,1,1,1,1,1,1,1,1,1
1,1,0,0,0,0,0,0,0,0,0,0,0,0,0,0,0,0,0,0,0,0,0,1,0
1,1,0,0,0,0,0,0,0,0,0,0,0,0,0,0,0,0,0,0,0,0,0,1,0
1,1,0,0,0,0,0,0,0,0,0,0,0,0,0,0,0,0,0,0,0,0,0,1,0
1,1,0,0,0,0,0,0,0,0,0,0,0,0,0,0,0,0,0,0,0,0,0,1,0
1,1,0,0,0,0,0,0,0,0,0,0,0,0,0,0,0,0,0,0,0,0,0,1,0
1,1,0,0,0,0,0,0,0,0,0,0,0,0,0,0,0,0,0,0,0,0,0,1,0
1,1,0,0,0,0,0,0,0,0,0,0,0,0,0,0,0,0,0,0,0,0,0,1,0
1,1,0,0,0,0,0,0,0,0,0,0,0,0,0,0,0,0,0,0,0,0,0,1,0
1,1,0,0,0,0,0,0,0,0,0,0,0,0,0,0,0,0,0,0,0,0,0,1,0
1,1,0,0,0,0,0,0,0,0,0,0,0,0,0,0,0,0,0,0,0,0,0,1,0
1,1,0,0,0,0,0,0,0,0,0,0,0,0,0,1,1,1,1,1,0,0,0,1,0
1,1,0,0,0,0,0,0,0,0,0,0,0,0,0,0,1,1,1,1,0,0,0,1,0
1,1,0,0,0,0,0,0,0,0,0,0,0,0,1,1,1,1,1,1,1,0,0,1,0
1,1,0,0,0,0,0,0,0,0,0,0,0,0,1,1,1,1,1,1,1,0,0,1,0
1,1,0,0,0,0,0,0,0,0,0,0,0,0,1,1,1,1,1,1,1,0,0,1,0
1,1,0,0,0,0,0,0,0,0,0,0,0,0,1,1,1,1,1,1,1,0,0,1,0
1,1,0,0,0,0,0,0,0,0,0,0,0,0,0,0,0,0,0,0,0,0,0,1,0
1,1,1,1,1,1,1,1,1,1,1,1,1,1,1,1,1,1,1,1,1,1,1,1,1
1,1,1,1,1,1,1,1,1,1,1,1,1,1,1,1,1,1,1,1,1,1,1,1,1
1,1,1,1,1,1,1,1,1,1,1,1,1,1,1,1,1,1,1,1,1,1,1,1,1





