18,18,18,18,18,18,18,18,18,18,18,18,18,18,18,18,18,18,18,18,18,18,18,18,18,18,18,18,18,18,18,18,18,18,18,18,18,18,18,18,18,18,18,18,18,18,18,18,18,18,
28,21,21,21,21,21,21,21,21,21,21,21,29,18,18,18,18,18,18,28,21,21,21,21,21,21,21,21,21,21,21,21,21,21,21,21,29,18,18,18,18,28,21,21,21,21,21,21,21,29,
23,76,76,76,76,76,76,76,76,76,76,76,24,18,18,18,18,18,18,23,76,76,76,76,76,76,76,76,76,76,76,76,76,76,76,76,24,18,18,18,18,23,76,76,76,76,76,76,76,24,
23,76,15,7,7,7,7,7,7,7,4,76,24,18,18,18,18,18,18,23,76,76,76,76,76,76,76,76,76,76,76,76,76,76,76,76,24,18,18,28,21,20,76,76,76,76,76,76,76,24,
23,76,8,2,2,2,2,2,2,2,10,76,19,21,21,21,21,21,21,20,76,76,76,76,76,76,76,76,76,76,76,76,76,76,76,76,19,21,21,20,76,76,76,76,76,76,76,76,76,24,
23,76,8,2,2,2,2,2,2,2,11,7,7,7,7,7,7,7,7,7,7,7,7,7,7,7,7,7,7,7,7,7,7,7,7,7,7,7,76,76,76,76,76,76,76,76,76,76,76,24,
23,76,8,2,2,2,2,2,2,2,13,9,9,9,9,9,9,9,9,9,9,9,9,9,9,9,9,9,9,9,9,9,9,12,13,9,9,9,76,76,76,76,76,76,76,76,76,76,76,24,
23,76,8,2,2,2,2,2,2,2,10,76,30,22,22,22,22,22,22,16,76,76,76,76,59,60,76,76,76,76,76,76,76,8,10,76,30,22,16,76,76,76,76,76,76,76,76,76,76,24,
23,76,8,2,2,2,2,2,2,2,10,76,24,18,18,18,18,18,18,23,76,76,76,76,50,48,76,76,76,76,76,76,76,8,10,76,24,18,27,22,22,16,76,76,76,76,76,76,76,24,
23,76,8,2,2,2,2,2,2,2,10,76,24,18,18,18,18,18,18,23,76,76,76,76,50,48,76,76,76,76,30,22,16,8,10,30,26,18,18,18,18,23,76,76,76,76,76,76,76,24,
23,76,8,2,2,2,2,2,2,2,10,76,24,18,18,18,18,18,18,23,76,59,49,49,53,54,49,49,60,76,24,18,23,8,10,19,21,21,21,21,29,23,76,76,76,76,76,76,76,24,
23,76,8,2,2,2,2,2,2,2,10,76,24,18,18,18,18,18,18,23,76,58,47,47,47,47,47,47,46,76,24,18,23,8,11,7,7,7,7,4,24,23,76,76,76,76,76,76,76,24,
23,76,8,2,2,2,2,2,2,2,10,76,24,18,18,18,18,18,18,23,76,76,76,76,76,76,76,76,76,76,24,18,23,5,9,9,9,9,12,10,24,23,76,76,76,76,76,76,76,24,
23,76,8,2,2,2,2,2,2,2,10,76,24,18,18,18,18,18,18,23,76,76,76,76,76,76,76,76,76,76,24,18,27,22,22,22,22,16,8,10,24,27,22,22,22,22,22,22,22,26,
23,76,8,2,2,2,2,2,2,2,10,76,24,18,18,18,18,18,18,27,22,22,22,22,22,22,22,22,22,22,26,18,18,18,18,18,28,20,5,6,19,21,21,21,21,21,21,21,29,18,
23,76,8,2,2,2,2,2,2,2,10,76,24,18,18,18,18,18,18,18,18,18,18,18,18,18,18,18,18,18,18,18,18,18,18,18,23,76,76,76,76,76,76,76,76,76,76,76,24,18,
23,76,8,2,2,2,2,2,2,2,10,76,24,18,18,18,18,18,18,18,18,18,18,18,18,18,18,18,18,18,18,18,18,18,18,18,23,76,59,60,76,76,76,76,76,59,60,76,24,18,
23,76,8,2,2,2,2,2,2,2,10,76,24,18,18,18,18,18,18,18,18,18,18,18,18,18,18,18,18,18,18,18,18,18,18,18,23,76,50,48,76,76,76,76,76,50,48,76,24,18,
23,76,8,2,2,2,2,2,2,2,10,76,19,21,21,21,21,21,21,21,21,21,21,21,21,21,21,21,21,21,21,21,21,29,18,18,23,76,50,48,76,76,76,76,76,50,48,76,24,18,
23,76,8,2,2,2,2,2,2,2,10,76,76,76,76,76,76,76,76,76,76,76,76,76,76,76,76,76,76,76,76,76,76,24,18,18,23,76,50,54,49,49,49,49,49,53,48,76,24,18,
23,76,8,2,2,2,2,2,2,2,11,7,7,7,7,7,7,7,7,7,7,7,7,7,7,7,7,7,7,7,7,4,76,24,18,18,23,76,50,52,47,47,47,47,47,47,46,76,24,18,
23,76,8,2,2,2,2,2,2,2,2,2,2,2,2,2,2,2,2,2,2,2,2,2,2,2,2,2,2,2,2,10,76,24,18,18,23,76,50,48,76,76,76,76,76,76,76,76,24,18,
23,76,8,2,2,2,2,2,2,2,2,2,2,2,2,2,2,2,2,2,2,2,2,2,2,2,2,2,2,2,2,10,76,24,18,18,23,76,50,48,76,76,76,76,76,76,76,76,24,18,
23,76,8,2,2,2,2,2,2,2,2,2,2,2,2,2,2,2,2,2,2,2,2,2,2,2,2,2,2,2,2,10,76,24,18,18,23,76,50,48,76,76,76,76,76,76,76,76,24,18,
23,76,8,2,2,2,2,2,2,2,2,2,2,2,2,2,2,2,2,2,2,2,2,2,2,2,2,2,2,2,2,10,76,24,18,18,23,76,50,54,49,49,49,49,49,49,60,76,24,18,
23,76,8,2,2,2,2,2,2,2,2,2,2,2,2,2,2,2,2,2,2,2,2,2,2,2,2,2,2,2,2,10,76,24,18,18,23,76,58,47,47,47,47,47,47,47,46,76,24,18,
23,76,8,2,2,2,2,2,2,2,2,2,2,2,2,2,2,2,2,2,2,2,2,2,2,2,2,2,2,2,2,10,76,24,18,18,23,76,76,76,76,76,76,76,76,76,76,76,24,18,
23,76,5,9,9,12,13,9,9,9,9,9,9,9,9,9,9,9,9,9,9,9,9,9,9,9,9,9,12,13,9,6,76,24,18,18,27,22,22,22,22,22,22,22,22,22,22,22,26,18,
23,76,76,76,76,8,10,76,76,76,76,76,76,76,76,76,76,76,76,76,76,76,76,76,76,76,76,76,8,10,76,76,76,24,18,18,18,18,18,18,18,18,18,18,18,18,18,18,18,18,
27,22,22,22,16,8,10,30,22,22,22,22,22,22,22,22,22,22,22,22,22,22,22,22,22,22,22,16,8,10,30,22,22,26,18,18,28,21,21,21,21,21,21,21,21,29,18,18,18,18,
18,18,18,18,23,8,10,24,18,18,18,18,18,18,18,18,18,18,18,18,18,18,18,18,18,18,18,23,8,10,24,18,18,18,18,18,23,31,32,39,35,15,4,76,76,19,29,18,18,18,
18,18,18,18,23,8,10,24,18,18,18,18,18,18,18,18,18,18,18,18,18,18,18,18,18,18,18,23,8,10,24,18,18,18,18,18,23,32,43,40,38,8,10,76,76,76,24,18,18,18,
28,21,21,21,20,5,6,19,21,21,21,21,21,21,21,21,21,21,21,21,21,21,21,29,18,18,18,23,8,10,24,18,18,18,18,18,23,36,40,40,38,8,10,76,76,76,24,18,18,18,
23,76,76,76,76,59,60,76,76,76,76,76,76,76,76,76,76,76,76,76,76,76,76,24,18,18,18,23,8,10,19,21,21,21,21,21,20,34,37,37,33,8,10,76,76,76,24,18,18,18,
23,76,76,76,76,50,48,76,76,76,76,76,76,76,76,76,76,76,76,76,76,76,76,24,18,18,18,23,8,11,7,7,7,7,7,7,7,7,7,7,7,14,10,76,76,76,24,18,18,18,
23,76,76,59,49,53,54,49,49,49,49,49,49,49,49,49,49,49,49,49,60,76,76,24,18,18,18,23,5,9,9,9,9,9,9,9,9,9,9,9,9,9,6,76,76,76,24,18,18,18,
23,76,76,58,47,47,47,47,47,47,47,47,47,47,47,47,47,47,47,47,46,76,76,24,18,18,18,27,22,22,22,22,22,22,22,22,16,76,76,76,76,76,76,76,76,76,24,18,18,18,
23,76,76,76,76,76,76,76,76,76,76,76,76,76,76,76,76,76,76,76,76,76,76,24,18,18,18,18,18,18,18,18,18,18,18,18,23,76,76,76,76,76,76,76,76,76,24,18,18,18,
23,76,76,76,76,76,76,76,76,76,76,76,76,76,76,76,76,76,76,76,76,76,76,24,18,18,18,18,18,18,18,18,18,18,18,18,27,22,22,22,22,22,22,22,22,22,26,18,18,18,
27,22,22,22,22,22,22,22,22,22,22,22,22,22,22,22,22,22,22,22,22,22,22,26,18,18,18,18,18,18,18,18,18,18,18,18,18,18,18,18,18,18,18,18,18,18,18,18,18,18,

0,0,0,0,0,0,0,0,0,0,0,0,0,0,0,0,0,0,0,0,0,0,0,0,0,0,0,0,0,0,0,0,0,0,0,0,0,0,0,0,0,0,0,0,0,0,0,0,0,0,
0,0,0,0,0,0,0,0,0,0,0,0,0,0,0,0,0,0,0,0,0,0,0,0,0,0,0,0,0,0,0,0,0,0,0,0,0,0,0,0,0,0,0,0,0,0,0,0,0,0,
0,0,0,0,0,0,0,0,0,0,0,0,0,0,0,0,0,0,0,0,72,63,63,63,63,63,63,63,63,63,63,63,63,63,63,75,0,0,0,0,0,0,72,63,63,63,63,63,75,0,
0,0,0,0,0,0,0,0,0,0,0,0,0,0,0,0,0,0,0,0,62,68,68,68,68,68,68,68,68,68,68,68,68,68,68,64,0,0,0,0,0,0,62,68,68,68,68,68,64,0,
0,0,0,0,0,0,0,0,0,0,0,0,0,0,0,0,0,0,0,0,61,65,65,65,65,65,65,65,65,65,65,65,65,65,65,74,0,0,0,0,0,31,61,65,65,65,65,73,64,0,
0,0,0,0,0,0,0,0,0,0,0,0,0,0,0,0,0,0,0,0,0,0,0,0,0,0,0,0,0,0,0,0,0,0,0,0,0,0,49,49,49,49,49,49,49,49,60,62,64,0,
0,0,0,0,0,0,0,0,0,0,0,0,0,0,0,0,0,0,0,0,0,0,0,0,0,0,0,0,0,0,0,0,0,0,0,0,0,0,47,47,47,47,47,47,47,51,48,62,64,0,
0,0,0,0,0,0,0,0,0,0,0,0,0,0,0,0,0,0,0,0,32,39,39,35,0,0,32,39,39,35,0,0,0,0,0,0,0,0,0,0,31,31,72,63,75,50,48,62,64,0,
0,0,0,0,0,0,0,0,0,0,0,0,0,0,0,0,0,0,0,0,36,40,40,38,0,0,36,40,40,38,0,0,0,0,0,0,0,0,0,0,0,0,62,68,64,50,48,62,64,0,
0,0,0,0,0,0,0,0,0,0,0,0,0,0,0,0,0,0,0,0,34,37,37,33,0,0,34,37,37,33,0,0,0,0,0,0,0,0,0,0,0,0,62,68,64,50,48,62,64,0,
0,0,0,0,0,0,0,0,0,0,0,0,0,0,0,0,0,0,0,0,31,0,0,0,0,0,0,0,0,31,0,0,0,0,0,0,0,0,0,0,0,0,62,68,64,50,48,62,64,0,
0,0,0,0,0,0,0,0,0,0,0,0,0,0,0,0,0,0,0,0,31,0,0,0,0,0,0,0,0,31,0,0,0,0,0,0,0,0,0,0,0,0,62,68,64,50,48,62,64,0,
0,0,0,0,0,0,0,0,0,0,0,0,0,0,0,0,0,0,0,0,72,63,63,63,63,63,63,63,63,75,0,0,0,0,0,0,0,0,0,0,0,0,61,65,74,58,46,61,74,0,
0,0,0,0,0,0,0,0,0,0,0,0,0,0,0,0,0,0,0,0,61,65,65,65,65,65,65,65,65,74,0,0,0,0,0,0,0,0,0,0,0,0,0,0,0,0,0,0,0,0,
0,0,0,0,0,0,0,0,0,0,0,0,0,0,0,0,0,0,0,0,0,0,0,0,0,0,0,0,0,0,0,0,0,0,0,0,0,0,0,0,0,0,0,0,0,0,0,0,0,0,
0,0,0,0,0,0,0,0,0,0,0,0,0,0,0,0,0,0,0,0,0,0,0,0,0,0,0,0,0,0,0,0,0,0,0,0,0,31,0,0,31,0,0,31,0,0,31,0,0,0,
0,0,0,0,0,0,0,0,0,0,0,0,0,0,0,0,0,0,0,0,0,0,0,0,0,0,0,0,0,0,0,0,0,0,0,0,0,0,0,0,0,0,0,0,0,0,0,0,0,0,
0,0,0,0,0,0,0,0,0,0,0,0,0,0,0,0,0,0,0,0,0,0,0,0,0,0,0,0,0,0,0,0,0,0,0,0,0,31,0,0,0,31,0,0,31,0,0,0,0,0,
0,0,0,0,0,0,0,0,0,0,0,0,0,0,0,0,0,0,0,0,0,0,0,0,0,0,0,0,0,0,0,0,0,0,0,0,0,31,0,0,0,0,0,0,0,0,0,0,0,0,
0,0,0,0,0,0,0,0,0,0,0,0,0,0,0,0,0,0,0,0,0,0,0,0,0,0,0,0,0,0,0,0,0,0,0,0,0,0,0,0,0,0,0,0,0,0,0,31,0,0,
0,0,0,0,0,0,0,0,0,0,0,0,0,0,0,0,0,0,0,0,0,0,0,0,0,0,0,0,0,0,0,0,0,0,0,0,0,0,0,0,0,0,0,0,0,0,0,0,0,0,
0,0,0,0,0,0,0,0,0,0,0,0,0,0,0,0,0,0,0,0,0,0,0,0,0,0,0,0,0,0,0,0,0,0,0,0,0,31,0,0,31,0,0,0,0,0,31,31,0,0,
0,0,0,0,0,0,0,0,0,0,0,0,0,0,0,0,0,0,0,0,0,0,0,0,0,0,0,0,0,0,0,0,0,0,0,0,0,0,0,0,0,0,0,31,0,0,0,0,0,0,
0,0,0,0,0,0,0,0,0,0,0,0,0,0,0,0,0,0,0,0,0,0,0,0,0,0,0,0,0,0,0,0,0,0,0,0,0,31,0,0,0,31,0,0,0,0,0,31,0,0,
0,0,0,0,0,0,0,0,0,0,0,0,0,0,0,0,0,0,0,0,0,0,0,0,0,0,0,0,0,0,0,0,0,0,0,0,0,31,0,0,0,0,0,0,0,0,0,0,0,0,
0,0,0,0,0,0,0,0,0,0,0,0,0,0,0,0,0,0,0,0,0,0,0,0,0,0,0,0,0,0,0,0,0,0,0,0,0,0,0,0,0,0,0,0,0,0,0,0,0,0,
0,0,0,0,0,0,0,0,0,0,0,0,0,0,0,0,0,0,0,0,0,0,0,0,0,0,0,0,0,0,0,0,0,0,0,0,0,31,31,0,0,31,31,0,0,31,0,31,0,0,
0,0,0,0,0,0,0,0,0,0,0,0,0,0,0,0,0,0,0,0,0,0,0,0,0,0,0,0,0,0,0,0,0,0,0,0,0,0,0,0,0,0,0,0,0,0,0,0,0,0,
0,0,0,0,0,0,0,0,0,0,0,0,0,0,0,0,0,0,0,0,0,0,0,0,0,0,0,0,0,0,0,0,0,0,0,0,0,0,0,0,0,0,0,0,0,0,0,0,0,0,
0,0,0,0,0,0,0,0,0,0,0,0,0,0,0,0,0,0,0,0,0,0,0,0,0,0,0,0,0,0,0,0,0,0,0,0,0,0,0,0,0,0,0,0,0,0,0,0,0,0,
0,0,0,0,0,0,0,0,0,0,0,0,0,0,0,0,0,0,0,0,0,0,0,0,0,0,0,0,0,0,0,0,0,0,0,0,0,0,0,0,0,0,0,72,75,0,0,0,0,0,
0,0,0,0,0,0,0,0,0,0,0,0,0,0,0,0,0,0,0,0,0,0,0,0,0,0,0,0,0,0,0,0,0,0,0,0,0,0,0,0,0,0,0,62,67,75,0,0,0,0,
0,0,0,0,0,0,0,0,0,0,0,0,0,0,0,0,0,0,0,0,0,0,0,0,0,0,0,0,0,0,0,0,0,0,0,0,0,0,0,0,0,0,0,62,67,64,0,0,0,0,
0,72,63,63,75,0,0,72,63,63,63,63,63,63,63,63,63,63,63,63,63,63,75,0,0,0,0,0,0,0,0,0,0,0,0,0,0,0,0,0,0,0,0,62,67,64,0,0,0,0,
0,62,66,65,74,0,0,61,65,65,65,65,65,65,65,65,65,65,65,65,65,73,64,0,0,0,0,0,0,0,0,0,0,0,0,0,0,0,0,0,0,0,0,62,67,64,0,0,0,0,
0,62,64,0,0,0,0,0,0,0,0,0,0,0,0,0,0,0,0,0,0,62,64,0,0,0,0,0,0,0,0,0,0,0,0,0,0,0,0,0,0,0,0,62,67,64,0,0,0,0,
0,62,64,0,0,0,0,0,0,0,0,0,0,0,0,0,0,0,0,0,0,62,64,0,0,0,0,0,0,0,0,0,0,0,0,0,0,72,63,63,63,63,63,67,67,64,0,0,0,0,
0,62,68,63,63,63,63,63,63,63,63,63,63,63,63,63,63,63,63,63,63,67,64,0,0,0,0,0,0,0,0,0,0,0,0,0,0,61,65,65,65,65,65,65,65,74,0,0,0,0,
0,61,65,65,65,65,65,65,65,65,65,65,65,65,65,65,65,65,65,65,65,65,74,0,0,0,0,0,0,0,0,0,0,0,0,0,0,0,0,0,0,0,0,0,0,0,0,0,0,0,
0,0,0,0,0,0,0,0,0,0,0,0,0,0,0,0,0,0,0,0,0,0,0,0,0,0,0,0,0,0,0,0,0,0,0,0,0,0,0,0,0,0,0,0,0,0,0,0,0,0,

0,0,0,0,0,0,0,0,0,0,0,0,0,0,0,0,0,0,0,0,0,0,0,0,0,0,0,0,0,0,0,0,0,0,0,0,0,0,0,0,0,0,0,0,0,0,0,0,0,0,
1,1,1,1,1,1,1,1,1,1,1,1,1,0,0,0,0,0,0,1,1,1,1,1,1,1,1,1,1,1,1,1,1,1,1,1,1,0,0,0,0,1,1,1,1,1,1,1,1,1,
1,0,0,0,0,0,0,0,0,0,0,0,1,0,0,0,0,0,0,1,0,0,0,0,0,0,0,0,0,0,0,0,0,0,0,0,1,0,0,0,0,1,0,0,0,0,0,0,0,1,
1,0,0,0,0,0,0,0,0,0,0,0,1,0,0,0,0,0,0,1,0,0,0,0,0,0,0,0,0,0,0,0,0,0,0,0,1,0,0,1,1,1,1,0,0,0,0,0,0,1,
1,0,0,0,0,0,0,0,0,0,0,0,1,1,1,1,1,1,1,1,1,1,1,1,1,1,1,1,1,1,1,1,1,1,1,1,1,1,1,1,0,0,1,1,1,1,1,1,0,1,
1,0,0,0,0,0,0,0,0,0,0,0,0,0,0,0,0,0,0,0,0,0,0,0,0,0,0,0,0,0,0,0,0,0,0,0,0,0,0,0,0,0,0,0,0,0,0,1,0,1,
1,0,0,0,0,0,0,0,0,0,0,0,0,0,0,0,0,0,0,0,0,0,0,0,0,0,0,0,0,0,0,0,0,0,0,0,0,0,0,0,0,0,0,0,0,0,0,1,0,1,
1,0,0,0,0,0,0,0,0,0,0,0,1,1,1,1,1,1,1,1,0,0,0,0,0,0,0,0,0,0,0,0,0,0,0,0,1,1,1,0,0,0,1,1,1,0,0,1,0,1,
1,0,0,0,0,0,0,0,0,0,0,0,1,0,0,0,0,0,0,1,0,0,0,0,0,0,0,0,0,0,0,0,0,0,0,0,1,0,1,1,1,1,1,1,1,0,0,1,0,1,
1,0,0,0,0,0,0,0,0,0,0,0,1,0,0,0,0,0,0,1,0,0,0,0,0,0,0,0,0,0,1,1,1,0,0,1,1,0,0,0,0,1,0,0,1,0,0,1,0,1,
1,0,0,0,0,0,0,0,0,0,0,0,1,0,0,0,0,0,0,1,0,0,0,0,0,0,0,0,0,0,1,0,1,0,0,1,1,1,1,1,1,1,0,0,1,0,0,1,0,1,
1,0,0,0,0,0,0,0,0,0,0,0,1,0,0,0,0,0,0,1,0,0,0,0,0,0,0,0,0,0,1,0,1,0,0,0,0,0,0,0,1,1,0,0,1,0,0,1,0,1,
1,0,0,0,0,0,0,0,0,0,0,0,1,0,0,0,0,0,0,1,1,1,1,1,1,1,1,1,1,1,1,0,1,0,0,0,0,0,0,0,1,1,0,0,1,0,0,1,1,1,
1,0,0,0,0,0,0,0,0,0,0,0,1,0,0,0,0,0,0,1,1,1,1,1,1,1,1,1,1,1,1,0,1,1,1,1,1,1,0,0,1,1,1,1,1,1,1,1,1,1,
1,0,0,0,0,0,0,0,0,0,0,0,1,0,0,0,0,0,0,1,1,1,1,1,1,1,1,1,1,1,1,0,0,0,0,0,1,1,0,0,1,1,1,1,1,1,1,1,1,0,
1,0,0,0,0,0,0,0,0,0,0,0,1,0,0,0,0,0,0,0,0,0,0,0,0,0,0,0,0,0,0,0,0,0,0,0,1,0,0,0,0,0,0,0,0,0,0,0,1,0,
1,0,0,0,0,0,0,0,0,0,0,0,1,0,0,0,0,0,0,0,0,0,0,0,0,0,0,0,0,0,0,0,0,0,0,0,1,0,0,0,0,0,0,0,0,0,0,0,1,0,
1,0,0,0,0,0,0,0,0,0,0,0,1,0,0,0,0,0,0,0,0,0,0,0,0,0,0,0,0,0,0,0,0,0,0,0,1,0,0,0,0,0,0,0,0,0,0,0,1,0,
1,0,0,0,0,0,0,0,0,0,0,0,1,1,1,1,1,1,1,1,1,1,1,1,1,1,1,1,1,1,1,1,1,1,0,0,1,0,0,0,0,0,0,0,0,0,0,0,1,0,
1,0,0,0,0,0,0,0,0,0,0,0,0,0,0,0,0,0,0,0,0,0,0,0,0,0,0,0,0,0,0,0,0,1,0,0,1,0,0,0,0,0,0,0,0,0,0,0,1,0,
1,0,0,0,0,0,0,0,0,0,0,0,0,0,0,0,0,0,0,0,0,0,0,0,0,0,0,0,0,0,0,0,0,1,0,0,1,0,0,0,0,0,0,0,0,0,0,0,1,0,
1,0,0,0,0,0,0,0,0,0,0,0,0,0,0,0,0,0,0,0,0,0,0,0,0,0,0,0,0,0,0,0,0,1,0,0,1,0,0,0,0,0,0,0,0,0,0,0,1,0,
1,0,0,0,0,0,0,0,0,0,0,0,0,0,0,0,0,0,0,0,0,0,0,0,0,0,0,0,0,0,0,0,0,1,0,0,1,0,0,0,0,0,0,0,0,0,0,0,1,0,
1,0,0,0,0,0,0,0,0,0,0,0,0,0,0,0,0,0,0,0,0,0,0,0,0,0,0,0,0,0,0,0,0,1,0,0,1,0,0,0,0,0,0,0,0,0,0,0,1,0,
1,0,0,0,0,0,0,0,0,0,0,0,0,0,0,0,0,0,0,0,0,0,0,0,0,0,0,0,0,0,0,0,0,1,0,0,1,0,0,0,0,0,0,0,0,0,0,0,1,0,
1,0,0,0,0,0,0,0,0,0,0,0,0,0,0,0,0,0,0,0,0,0,0,0,0,0,0,0,0,0,0,0,0,1,0,0,1,0,0,0,0,0,0,0,0,0,0,0,1,0,
1,0,0,0,0,0,0,0,0,0,0,0,0,0,0,0,0,0,0,0,0,0,0,0,0,0,0,0,0,0,0,0,0,1,0,0,1,0,0,0,0,0,0,0,0,0,0,0,1,0,
1,0,0,0,0,0,0,0,0,0,0,0,0,0,0,0,0,0,0,0,0,0,0,0,0,0,0,0,0,0,0,0,0,1,0,0,1,1,1,1,1,1,1,1,1,1,1,1,1,0,
1,0,0,0,0,0,0,0,0,0,0,0,0,0,0,0,0,0,0,0,0,0,0,0,0,0,0,0,0,0,0,0,0,1,0,0,0,0,0,0,0,0,0,0,0,0,0,0,0,0,
1,1,1,1,1,0,0,1,1,1,1,1,1,1,1,1,1,1,1,1,1,1,1,1,1,1,1,1,0,0,1,1,1,1,0,0,1,1,1,1,1,1,1,1,1,1,0,0,0,0,
0,0,0,0,1,0,0,1,0,0,0,0,0,0,0,0,0,0,0,0,0,0,0,0,0,0,0,1,0,0,1,0,0,0,0,0,1,0,0,0,0,0,0,1,0,1,1,0,0,0,
0,0,0,0,1,0,0,1,0,0,0,0,0,0,0,0,0,0,0,0,0,0,0,0,0,0,0,1,0,0,1,0,0,0,0,0,1,0,0,0,0,0,0,1,0,0,1,0,0,0,
1,1,1,1,1,0,0,1,1,1,1,1,1,1,1,1,1,1,1,1,1,1,1,1,0,0,0,1,0,0,1,0,0,0,0,0,1,0,0,0,0,0,0,1,0,0,1,0,0,0,
1,0,0,0,1,0,0,1,0,0,0,0,0,0,0,0,0,0,0,0,0,0,0,1,0,0,0,1,0,0,1,1,1,1,1,1,1,0,0,0,0,0,0,1,0,0,1,0,0,0,
1,0,1,1,1,0,0,1,1,1,1,1,1,1,1,1,1,1,1,1,1,1,0,1,0,0,0,1,0,0,0,0,0,0,0,0,0,0,0,0,0,0,0,1,0,0,1,0,0,0,
1,0,1,0,0,0,0,0,0,0,0,0,0,0,0,0,0,0,0,0,0,1,0,1,0,0,0,1,0,0,0,0,0,0,0,0,0,0,0,0,0,0,0,1,0,0,1,0,0,0,
1,0,1,0,0,0,0,0,0,0,0,0,0,0,0,0,0,0,0,0,0,1,0,1,0,0,0,1,1,1,1,1,1,1,1,1,1,1,1,1,1,1,1,1,0,0,1,0,0,0,
1,0,1,1,1,1,1,1,1,1,1,1,1,1,1,1,1,1,1,1,1,1,0,1,0,0,0,0,0,0,0,0,0,0,0,0,1,0,0,0,0,0,0,0,0,0,1,0,0,0,
1,0,0,0,0,0,0,0,0,0,0,0,0,0,0,0,0,0,0,0,0,0,0,1,0,0,0,0,0,0,0,0,0,0,0,0,1,1,1,1,1,1,1,1,1,1,1,0,0,0,
1,1,1,1,1,1,1,1,1,1,1,1,1,1,1,1,1,1,1,1,1,1,1,1,0,0,0,0,0,0,0,0,0,0,0,0,0,0,0,0,0,0,0,0,0,0,0,0,0,0,
